1111111111111
100100000CCC1
1110011111001
1P1011E000001
1111111111111
