111111111111111111111111111
10010000000C100000000000001
100001111100100000000000001
1P0011E00000100000000000001
111111111111111111111111111
