1111111111111
100100E0000C1
1110011111001
1P1011E000E01
1111111111111
